Back in Black	ACDC
Don't Stop Me Now	Queen
Bohemian Rhapsody	Queen
Somebody That I Used To Know	Gotye
The Adults Are Talking	The Strokes
Shape of You	Ed Sheeran
Levels	Avicii
Counting Stars	OneRepublic
Highway to Hell ACDC 
Radioactive	Imagine Dragons
Believer	Imagine Dragons
Sugar	Maroon 5
Not Today	Twenty One Pilots
Stressed Out	Twenty One Pilots
Message Man	Twenty One Pilots
Lost On You	LP
Other People	LP
Sympathy For The Devil	The Rolling Stones
Lo malo de ser bueno	Cuarteto de Nos
Asi Soy Yo	Cuarteto de Nos
Maniac	Conan Gray
High Voltage	ACDC
Killer Queen	Queen
Till I Collapse	Eminem
Thunderstruck	ACDC
Naive	The Kooks
Junk Of The Heart	The Kooks
Rap God	Eminem
Lose Yourself	Eminem
Sunflower	Post Malone, Swae Lee
High Hopes	Panic! At The Disco
Enemy	Imagine Dragons
Another One Bites the Dust	Queen
Good Old Fashioned Lover Boy	Queen
Waiting For Love	Avcii
The Nights	Avcii
Wake Me Up	Avcii
Hey Brother	Avcii
Bones	Imagine Dragons
The Man	Taylor Swift
We Are Never Ever Getting Back Together	Taylor Swift
Llueve Sobre La Ciudad	Los Bunkers
Ahora Que No Estas	Los Bunkers
Ven Aqui	Los Bunkers
Ritual	Marshmello
Alone	Marshmello
BeFoRe U	Marshmello
Get Lucky	Daft Punk
Around the World	Daft Punk
Lose Yourself to Dance	Daft Punk






